                      
                         ****************************************
                       ********************************************
		      ********************************************** 
                     ************************************************ 
                    ********           S*****************        E****
                   ********  *****************************   **********
                  ********  ************   *****************  **********
                 ********  ***********       ****************   *********
                ********                ***********************   ********
               *************   *********************************   ********
              ********  ****   *********************      ******   *********
             ********  *****       ********   ****   ****   ****   **********
            ********  **********    *********      ********   **   ***********
           ********  *************    ********   ************      ************
          ********  *****************   ****      ******************************
           ******      *******   ******      ****   **************************
             ********   *****   *******************   **********************
               ********   **      *******************   ******************
                 *********   ***    *******************   **************
                   **************  ***************          **********
                    *************  ***               ****************
                      ***********  ***   **************************
                        *********  ***   ************************
                         ********       ************************
       			  *************************************
                           ***********************************