**********************************
**S  *****************************
**  ***         ******************
**  ***  *****  ******************
**       *****  ******************
**************            ********
*************************  *******
************      *******        *
***       **  **  *******  *******
***  ***  **  **           *******
***           **  *****    *******
***  ***********      ***      ***
***  ************************  ***
***  **      ************      ***
***  **  **   ***********  *******
***      **        ***************
***********  ****               E*
***********   ********************
**********************************