*************************************
*                *                  *
*         ***   *             E     *
*         *    *                    *
*         *    *                    *
*         *   **                    *
* S       *                         *
*************************************